111111
100001
100001
100101
111 11