
F 35,139,34
C 135,206,235

SO ./textures/redborder.xpm
EA ./textures/wood.xpm
NO ./textures/eagle.xpm
WE ./textures/redbrick.xpm

111111111
100000001
1000E0001
100000001  
111111111
