
F 34,139,34
C 135,206,235

SO ./textures/redborder.xpm
EA ./textures/wood.xpm
NO ./textures/eagle.xpm
WE ./textures/redbrick.xpm

1111 1
100011
100S01
100001
111111