
WE ./textures/redbrick.xpm

SO ./textures/redborder.xpm
EA ./textures/wood.xpm
NO  ./textures/eagle.xpm


F 34,139,34
C 135,206,235

 1       1
1N111111101
1000000111
100000001
100000001  
111111111
