
SO ./textures/redborder.xpm
EA ./textures/wood.xpm
NO ./textures/eagle.xpm
WE ./textures/redbrick.xpm



F 34,139,34
C 135,206,235


1111 1
101111
100001
1000N1
111111
