
F   34,139,34
C   135,206,235

SO ./textures/redborder.xpm
EA ./textures/wood.xpm
NO ./textures/eagle.xpm
WE ./textures/redbrick.xpm

111111111
1000S000001
100000001
10000000001
111111111