
F 34,139,34
C 135,206,235

SO ./textures/redborder.xpm
EA ./textures/wood.xpm
NO ./textures/eagle.xpm
WE ./textures/redbrick.xpm


1111 1
100111
N00001
100001
111111