


SO ./textures/redborder.xpm
EA ./textures/wood.xpm
NO ./textures/eagle.xpm
WE ./textures/redbrick.xpm

F 34,139,34
C 135,206,235

11111111111111
10000000000001
10000000000001
10000W00000001
10000000001111
10000000000001
10001110000001
11111 11111111