11111111111
10011100001
1001 100001
10011100001
10000000001
11111111111