11111111111111
10000000000001
10000000000001
10000000000001
10000000001111
10000000000001
10001010000001
11111 11111111