
SO ./textures/redborder.xpm
EA			 			 			 ./textures/wood.xpm
NO      ./textures/eagle.xpm
WE ./textures/redbrick.xpm

F 34,139,34
C 135,206,235

        1111111111 11111111111111
        1000000000110000000000001
        1011000001110000000000001
        1001000000000000000N00001
111111111011000001110000000000001
100000000000000001110111101111111
11110111111100011100000010001
111101     100011101010010001
11000111111101011100000010001
1000000000000001100000010001
10000000000000001101010010011
1100000111000001111101111001
11100111 1000001 101111 10011
11100111 1111111 111111 11111
1000001
1000001
1000001
1000001
1111111