
SO ./textures/redborder.xpm
EA			 			 			 ./textures/wood.xpm
NO      ./textures/eagle.xpm
WE ./textures/redbrick.xpm

C 135,206,235

F 34,139,34


                               111
        1111111111 111111111111101
        1000000001 100000000000N1
        1011000001110000000000001
        100100000000000000000001   
111111111011000001110000000000011
100000000000000001110111101111111
11110111111100011100000010001
111101     100011101010010001
11000111111101011100000010011
1000000000000001100000010001
10000000000000001101010010011
110000011100000110101111001
11100111 1000001 101111 10011
11100111 1111111 111111  1111
1000001
1000001
1000001
1000001
1111111