SO ./textures/redborder.xpm
EA ./textures/wood.xpm
NO ./textures/eagle.xpm
WE ./textures/redbrick.xpm

F 34,139,34
C 135,206,235

        1111111111111111111111111
        1000000000110000000000001
        1011000001110000000000001
        1001000000000000000N00001
111111111011000001110000000000001
100000000011000001110111101111111
11110111111111011100000010001
 1110111111111011101010010001
11000000110101011100000010001
10000000000000001100000010001
10000000000000001101010010011
1100000111010101111101111001
11110111 1110101 101111010011
11111111 1111111 111111111111