
F   34,139,34
C   135,206,235

SO ./textures/redborder.xpm
EA ./textures/wood.xpm
NO ./textures/eagle.xpm
WE ./textures/redbrick.xpm

11111111111111
10000000111111
10N00000000001
10000000111101
11111111111101
           101
           101
           101
           101
           101
           101
           101
           101
           101111111
           100000001
           111111111